0,0,0,0,0,0,0,0,0,1,0,0,0,0,1
0,0,0,0,0,0,0,0,0,1,7,3,0,0,1
0,0,0,0,0,0,0,0,0,1,1,1,0,0,1
0,0,0,0,0,0,0,0,0,0,0,0,0,0,1
0,0,0,0,0,0,0,0,0,0,0,0,0,0,1
0,3,0,0,0,0,0,3,0,0,0,0,0,0,1
0,1,0,0,3,0,0,1,0,0,3,3,0,0,1
0,0,0,0,1,0,0,0,0,0,1,1,0,0,1
4,4,4,4,4,4,4,4,4,4,1,1,5,5,1
1,1,1,1,1,1,1,1,1,1,1,1,1,1,1