1,1,1,1,1,1,1,1,1,1,1,1,1,1,1,1,1,1,1,1,1,1,1,1,1,1,1,1,1,1,1,1,1,1,1,1,1,1,1,1
1,0,0,0,0,0,0,0,0,0,0,3,3,0,0,3,0,0,0,0,0,0,0,0,0,0,0,0,0,0,0,0,0,0,0,0,0,0,0,1
1,0,0,0,0,3,0,3,3,0,3,0,1,3,3,0,3,0,0,0,0,0,0,0,0,3,3,3,0,0,0,0,0,0,0,0,3,3,0,1
1,6,0,0,1,4,1,4,4,1,4,4,1,4,4,4,1,3,0,0,0,3,3,3,0,0,0,0,0,0,3,3,3,0,0,3,0,0,3,1
1,1,1,1,1,1,1,1,1,1,1,1,1,1,1,1,1,1,1,1,1,1,1,1,1,1,1,1,1,1,1,1,1,1,1,1,1,0,3,1
1,3,0,0,0,0,0,0,0,0,0,0,0,0,0,0,0,0,0,0,0,0,0,0,0,0,0,1,0,0,0,0,0,0,0,0,1,0,3,1
1,3,0,0,0,0,0,0,0,0,0,0,0,0,0,0,0,0,0,0,0,9,0,0,0,0,0,1,0,0,0,9,0,0,0,0,1,0,3,1
1,3,4,4,0,0,0,0,0,0,3,0,3,0,3,3,3,0,0,1,1,1,1,1,1,1,3,1,0,0,0,1,0,0,0,0,1,0,3,1
1,0,1,1,0,0,0,0,0,0,3,0,3,0,0,3,0,0,0,1,3,3,3,3,3,3,3,1,0,0,0,1,3,0,0,0,1,0,3,1
1,0,0,0,0,0,3,3,0,0,3,3,3,0,0,3,0,0,0,1,3,1,1,1,1,1,1,1,0,3,0,1,3,0,0,0,1,0,3,1
1,0,0,0,0,0,1,1,0,0,3,0,3,0,3,3,3,0,0,1,3,3,3,3,3,3,3,1,0,3,0,1,3,0,0,0,1,0,3,1
1,0,0,0,0,0,0,0,0,0,0,0,0,0,0,0,0,0,0,1,1,1,1,1,1,1,3,1,0,3,0,1,3,0,0,0,1,0,3,1
1,0,0,0,0,0,0,0,0,0,0,0,0,0,0,0,0,0,0,0,0,0,0,0,0,0,0,1,0,3,4,1,5,0,0,0,1,0,3,1
1,0,0,0,0,0,0,0,0,0,0,0,0,0,0,0,0,0,0,0,0,0,0,0,0,0,0,1,0,0,1,1,1,0,0,0,1,0,3,1
1,5,0,0,0,0,0,0,0,0,0,0,5,5,0,5,5,0,0,0,0,0,0,0,0,0,0,1,0,0,0,1,0,0,0,0,1,0,3,1
1,1,0,0,0,0,0,0,0,0,0,0,1,1,0,1,1,0,0,0,0,0,0,0,0,0,0,1,0,0,0,1,0,0,0,0,1,0,3,1
1,0,0,0,0,0,0,0,0,0,0,0,1,3,3,3,1,0,0,0,0,0,0,0,0,0,0,1,0,0,3,1,0,0,0,3,1,0,3,1
1,0,0,0,0,0,0,0,0,0,0,0,0,3,3,3,0,0,0,0,0,0,0,0,0,0,0,1,0,0,3,1,0,0,0,3,1,0,3,1
1,0,3,0,9,0,4,0,0,5,0,0,1,3,3,3,1,0,3,0,0,0,0,0,0,3,3,1,0,0,3,1,0,0,0,3,1,0,3,1
1,3,0,0,1,1,1,0,0,1,0,0,1,1,0,1,1,0,1,0,0,0,0,0,0,3,3,1,4,4,0,1,0,0,0,3,1,3,0,1
1,3,0,0,0,0,0,0,0,0,0,0,0,0,3,0,0,0,0,0,0,0,0,0,0,3,3,1,1,1,0,1,0,0,0,5,1,3,0,1
1,3,0,0,0,0,0,0,0,0,0,0,0,0,3,0,0,0,0,0,0,0,0,0,0,3,3,1,0,0,0,1,0,0,0,1,1,3,0,1
1,3,0,4,0,0,0,0,0,0,0,0,0,0,3,0,0,0,0,0,0,0,0,0,0,3,3,1,0,0,0,1,0,0,0,0,1,3,0,1
1,3,0,1,0,0,0,0,0,0,0,0,0,0,0,0,0,0,0,0,0,0,0,0,0,3,3,1,0,0,0,1,0,0,0,0,1,3,0,1
1,3,0,1,0,0,0,0,0,0,0,0,0,0,0,0,0,0,0,0,0,3,3,0,0,3,3,1,0,0,0,1,0,0,0,0,1,3,0,1
1,3,0,1,0,0,0,3,3,3,3,3,0,0,0,0,0,0,0,3,3,0,1,1,1,5,5,1,0,3,0,1,3,0,0,0,1,3,0,1
1,3,0,1,3,1,1,1,1,1,1,1,1,1,1,1,1,1,1,1,1,1,1,1,1,1,1,1,0,3,0,1,3,0,0,0,1,3,0,1
1,3,0,1,3,0,0,0,0,0,0,0,0,0,0,0,0,0,0,0,0,0,0,0,0,0,0,1,0,3,0,1,3,0,0,0,1,3,0,1
1,3,0,1,3,0,0,0,0,0,0,0,0,0,0,0,0,0,0,3,0,0,0,3,0,0,0,1,0,3,0,1,3,0,0,0,0,3,0,1
1,3,0,1,3,0,0,0,0,0,0,0,0,0,0,0,0,0,3,0,3,0,3,0,3,0,0,1,0,3,4,1,5,0,0,0,0,3,0,1
1,3,0,1,3,0,0,0,0,0,0,0,3,3,4,0,0,0,0,4,0,0,0,4,0,0,0,1,0,0,1,1,1,1,1,1,1,3,0,1
1,3,0,1,3,0,0,0,0,0,0,0,1,1,1,0,0,0,0,1,0,0,0,1,0,0,0,0,0,0,3,3,0,0,0,0,1,3,0,1
1,3,0,1,0,0,0,0,0,0,0,0,0,0,0,0,0,0,0,0,0,0,0,0,0,0,0,0,0,0,3,3,0,0,0,0,1,3,0,1
1,3,0,1,0,3,0,0,0,0,0,0,0,0,0,0,0,0,0,0,0,0,0,0,0,0,0,0,0,0,0,0,0,0,0,0,1,3,0,1
1,3,0,1,5,1,3,3,0,0,0,0,0,0,0,0,0,3,0,0,0,3,0,0,0,3,0,0,0,0,0,0,0,0,0,0,1,3,0,1
1,3,0,1,1,1,1,1,1,1,0,0,0,0,0,0,0,3,0,0,0,3,0,0,0,3,0,0,0,0,0,0,0,0,0,0,1,3,0,1
1,3,0,0,3,3,0,3,0,1,0,0,0,0,0,0,0,3,0,0,0,3,0,0,0,3,0,0,0,0,0,0,3,3,3,3,1,3,0,1
1,0,0,0,0,0,0,0,7,1,0,0,0,0,0,0,0,3,0,0,0,3,0,0,0,3,0,0,0,0,0,0,3,3,3,3,1,3,0,1
1,4,4,1,4,4,1,4,1,1,4,4,4,4,4,4,4,5,4,4,4,5,4,4,4,5,4,1,0,0,0,0,3,3,3,9,1,5,5,1
1,1,1,1,1,1,1,1,1,1,1,1,1,1,1,1,1,1,1,1,1,1,1,1,1,1,1,1,5,5,1,1,1,1,1,1,1,1,1,1